################
#     G@G   #  #
#      G    #XX#
#  d        #  #
#              #
#     d        #
#              #
#  d       d   #
#             G#
#    d         #
#              #
#        d     #
#  d           #
#          d   #
#C            C#
################
