################
#X    L@G      #
# #            #
# #          # #
# #          # #
# #          # #
# #          # #
# #          # #
# #     S    # #
# #          # #
# #          # #
# #     C    # #
# #          # #
# ############ #
#              #
################
